NO ./textures/NO.jpg
SO ./textures/SO.jpg
WE ./textures/WE.jpg
EA ./textures/EA.jpg
D ./textures/door.jpg

F 0,255,1
C 0,100,255

        1111111111111111111111111
        1000000000110000000000001
        1011000001110000000000001
        1001000000000000000000001
111111111011000001110000000000001
100000000011000001110111111111111
11110111111101011100000010001
111101111111D1011101010010001
11000000110101011100000010001
1000000000000000DD000000D0001
10000000000000001101010010001
11000001110101011111011110N0111
11110111 1110101 101111010001
11111111 1111111 111111111111
